Pig
100
500
Pig
200
500
Pig
300
500
Sparrow
Humming Bird
Pigeon
Humming Bird
Pigeon
Pigeon
Pigeon

Map
00000000000000000000000000000000000000000000000
00000000000000000000000000000000000000000000000
00000000000000000000000000000000000000000000000
00000000000000000000000000000000000000000000000
00000000000000000010000000000000000000000000000
00000000000000000000000000000000000000000000000
00000000000000000000000000000000000000000000000
00000000000000000000000000000000000000000000000
00000000000000000000000000000000000000000000000
00000000000000000000000000000000000000000000000
00000000000000000000000000000000000000000000000
00000000000000100000000000000000000000000000000
00000000000000000000000000000000000000000000000
00000000000000000000000000000000000000000000000
00000000000000000000000000000000000000000000000
00000000000000000000000000000000000000000000000
00000000000000000002002002222200222200020002000
00000000000000000002002000020000200200022022000
00000000000000000002002000020000222220020202000
00000000000000000002002000020000200020020002000
00000000000000000002222000020000222220020002000
11111111111111111111111111111111111111111111111
