Sparrow
Humming Bird
Pigeon
Humming Bird
Pigeon
Pigeon
Pigeon
Map
00000000000000000000000000000000000000000000000
00000000000000000000000000000000000000000000000
00000000000000000000000000000000000000000000000
00000000000000000000000000000000000000000000000
00000000000000000000000000000000000000000000000
00000000000000000000000000000000000000000000000
00000000000000000000000000000000000000000000000
00000000000000000000000000000000000000000000000
00000000000000000000000000000000000000000000000
00000000000000000000000000000000000000000000000
00000000000000000000000000000000000000000000000
00000000000000000000000000000000000000000000000
00000000000000000000000000000000000000000000000
00000000000000000000000000000000000000000000000
00000000000000000000000000000000000000000000000
00000000000000000000000000000000000000000000000
00000000000000000002222002222200002000002222000
00000000000000000000002002000200022000000002000
00000000000000000002222002000200202000002222000
00000000000000000002300002000200002000002000000
00300000000000000002222002222200222220002222000
11111111111111111111111111111111111111111111111
