Sparrow
Humming Bird
Pigeon
Pigeon
Pigeon
Map
00000000000000000000000000000000000000000000000
00000000000000000000000000000000000000000000000
00000000000000000000000000000000000000000000000
00000000000000000000000000000000000000000000000
00000000000000000000000000000000000000000000000
00000000000000000000000011000000000000000000000
00000000000000000000000000000000000000000000000
00000000000000000000000000000000000000000000000
00000000000000000000000000000000000000000000000
00000000000000000000000000000000000000000000000
00000000000000000000000000000000000000000000000
00000000000000000000000000000000000000000000000
00000000000000000000000000000000000000000000000
00000000000000000000000000000000222222222200000
00000000000000000000000000000000200000000200000
00000000000000000000000000000000200000030200000
00000000000000000000222222222222222222222200000
00000000000000000000200000030200300020000200000
00000000000000000000200000222222222220000200000
00000000000000000000200000200000000020030200000
00000000000000000000222222200000000022222200000
11111111111111111111111111111111111111111111111
