Sparrow
Humming Bird
Pigeon
Humming Bird
Pigeon
Pigeon
Pigeon
Map
00000000000000000000000000000000000000000000000
00000000000000000000000000000000000000000000000
00000000000000000000000000000000000000000000000
00000000000000000000000000000000000000000000000
00000000000000000000000000000000000000000000000
00000000000000000000000000000000000000000000000
00000000000000000000000000000000000000000000000
00000000000000000000000000000000000000000000000
00000000000000000000000000000000000000000000000
00000000000000000000000000000000000000000000000
00000000000000000000000000000000000000000000000
00000000000000000000000000000000000000000000000
00000000000000000000000000000000000000000000000
00000000000000000000000000000000222222222200000
00000000000000000000000000000000200000000200000
00000000000000000000000000000000200000003200000
00000000000000000000222222222222222222222200000
00000000000000000000200000003200300020000200000
00000000000000000000200000222222222220000200000
00000000000000000000200000000200000020030200000
00000000000000000000222222222200000022222200000
11111111111111111111111111111111111111111111111
