Sparrow
Humming Bird
Pigeon
Humming Bird
Pigeon
Pigeon
Pigeon
Map
00000000000000000000000000000000000000000000000
00000000000000000000000000000000000000000000000
00000000000000000000000000000000000000000000000
00000000000000000000000000000000000000000000000
00000000000000000000000000000000000000000000000
00000000000000000000000000000000000000000000000
00000000000000000000000000000000000000000000000
00000000000000000000000000000000000000000000000
00000000000000000000000000000000000000000000000
00000000000000000000000000000000000000000000000
00000000000000000000000000000000000000000000000
00000000000000000000000000000000000000000000000
00000000000000000000000000000000000000000000000
00000000000000000000000000000000000000000000000
00000000000000000000000000000000000000000000000
00000000000000000000000000000000000000000000000
00000000000000000002222002222200222220000200000
00000000000000000002000000020000200020002200000
00000000000000000002022000020000200020020200000
00000000000000000002302000020000200020000200000
00300000000000000002222002222200222220022222000
11111111111111111111111111111111111111111111111
